######################
#  z # x # c # v #z  #
# #v# # # # # # # #  #
#x c  v z x c v z c ##
##x#c#z#v#z#x#c#v#z# #
#  z  x c v z x c v  #
# #z# # # # # # # #  #
#x c  v   z   x   c ##
##v# #x# #z# #c# #v# #
#x c  v   z   x   c ##
# #z# # # # # # # #  #
#  z  x   c   v   z  #
##v# #x# #z# #c# #v# #
#x c  v   z   x   c ##
#  z # x # c # v #z  #
######################