######################
#  z  v  z  v  z  v  #
# #  # #    ## #  #  #
#c  #   #  #    #   z#
#  #  x  ##  x   #   #
#z #   z    z    #  x#
#   #   c  c    x    #
#x#  #   vv    #  x c#
#                    #
#c     # zzz #      v#
# #     #   #     #  #
#v z x   # #   x v  z#
#         #          #
#z#  z  x  c  v z # x#
#  z  x  c  v  z  x  #
######################