######################
#  c# bc d* db# **c  #
# # **# #*c*d*# bc## #
#*#*d #c#* c*b*# *#*b#
# **#*dc #**bd c# #c##
#c*c#b *#ccc#*#*cbcd##
### #*# c*#* #*# # # #
# *cd* #  **dc #*# c #
#*##cc#* b*#*#  *#*#*#
#d#c  **### * cb * #d#
# #*d*b  *  ##*d*#*# #
#  *b #b#c*b # d#c*  #
#c*c#b *##b#c* *cbcd##
# # **# *c*d *# bc#* #
#  c#bc d* db## **d  #
######################